25 25
100 100
4 10 10 10 10 10 10 10 10 10 10 10 10 10 10 10 10 10 10 10 10 10 10 10 5
8 13 13 13 10 10 10 10 10 10 10 10 10 10 10 10 10 10 10 10 10 13 13 13 9
8 13 13 13 10 10 10 10 10 10 10 10 10 10 10 10 10 10 10 10 10 13 13 13 9
8 13 13 13 13 13 13 13 13 13 13 13 13 13 13 13 13 13 13 13 13 13 13 13 9
8 8  8  13 13 13 13 13 13 13 13 13 13 13 13 13 13 13 13 13 13 13 9  9  9
8 8  8  13 13 13 13 13 13 13 13 13 13 13 3  13 13 13 13 13 13 13 9  9  9
8 8  8  13 13 13 13 13 13 13 13 13 13 13 13 13 13 13 13 13 13 13 9  9  9
8 8  8  13 13 13 13 13 13 13 13 13 13 13 13 13 13 13 13 13 13 13 9  9  9
8 8  8  13 13 13 13 13 3  13 13 13 13 13 13 13 13 13 13 13 13 13 9  9  9
8 8  8  13 13 13 3  3  3  13 13 13 13 13 13 13 13 13 13 13 13 13 9  9  9
8 8  8  13 13 13 3  13 13 13 13 13 13 13 13 13 13 13 13 13 13 13 9  9  9
8 8  8  13 13 13 3  13 13 13 13 3  13 13 13 13 13 13 13 13 13 13 9  9  9
8 8  8  13 13 13 13 13 13 13 13 13 13 13 13 13 13 13 13 13 13 13 9  9  9
8 8  8  13 13 13 13 13 13 13 13 13 13 13 13 13 13 13 13 13 13 13 9  9  9
8 8  8  13 13 13 13 13 13 13 13 13 13 13 13 13 13 13 13 13 13 13 9  9  9
8 8  8  13 13 13 13 13 13 13 13 13 13 13 13 13 13 13 13 13 13 13 9  9  9
8 8  8  13 13 13 13 13 13 13 13 13 3  13 13 13 13 13 13 13 13 13 9  9  9
8 8  8  13 13 13 13 13 13 13 13 13 13 13 13 13 13 13 13 13 13 13 9  9  9
8 8  8  13 13 13 13 13 13 13 13 13 13 13 13 13 13 13 13 13 13 13 9  9  9
8 8  8  13 13 13 13 13 13 13 13 13 13 13 13 13 13 13 13 13 13 13 9  9  9
8 8  8  13 13 13 13 13 13 13 13 13 13 13 13 13 13 13 13 13 13 13 9  9  9
8 13 13 13 13 13 13 13 13 13 13 13 13 13 13 13 13 13 13 13 13 13 13 13 9
8 13 13 13 11 11 11 11 11 11 11 11 11 11 11 11 11 11 11 11 11 13 13 13 9
8 13 13 13 11 11 11 11 11 11 11 11 11 11 11 11 11 11 11 11 11 13 13 13 9
7 11 11 11 11 11 11 11 11 11 11 11 11 11 11 11 11 11 11 11 11 11 11 11 6